The Lighthouse	Robert Pattinson
The Lighthouse	Willem Dafoe
You should have left	Kevin Bacon
You should have left	Amanda Seyfried
Doctor Sleep	Ewan McGregor
BirdBox	Sandra Bullock
Ma	Octavia Spencer
Mamma Mia!	Amanda Seyfried
Letters to Juliet	Amanda Seyfried
In Time	Amanda Seyfried
Lovelave	Amanda Seyfried
Footloose	Kevin Bacon
Crazy, Stupid, Love	Kevin Bacon
Good Time	Robert Pattinson
Remember Me	Robert Pattinson
Cosmopolis	Robert Pattinson
Spider-Man	Willem Dafoe
Aquaman	Willem Dafoe
Van Gogh	Willem Dafoe
The Florida Project	Willem Dafoe
Trainspotting	Ewan McGregor
Moulin Rouge!	Ewan McGregor
Star Wars	Ewan McGregor
The Blind Side	Sandra Bullock
Miss Detective	Sandra Bullock
Oceans 8	Sandra Bullock
Gravity	Sandra Bullock
The shape of water	Octavia Spencer
The Help	Octavia Spencer